161
10
43 5 3 3 3 3 3 3 3 3 3 3 3 3 3 3 3 3 3 3 3 3 3 3 3 3 3 3 3 3 3 3 3 3 3 3 3 3 3 3 3 3 3 3 3 3 3 3 3 3 3 3 3 3 3 3 3 3 3 3 3 3 3 3 3 3 3 3 3 3 3 3 3 3 3 3 3 3 3 3 3 3 3 3 3 3 3 3 3 3 3 3 3 3 3 3 3 3 3 3 3 3 3 3 3 3 3 3 3 3 3 3 3 3 3 3 3 3 3 3 3 3 3 3 3 3 3 3 3 3 3 3 3 3 3 3 3 3 3 3 3 3 3 3 3 3 3 3 3 3 3 3 3 3 3 3 3 3 3 6 43 
43 2 0 0 0 0 0 0 0 0 0 0 0 0 0 0 0 0 0 0 0 0 0 0 0 0 0 0 0 0 0 0 0 0 0 0 0 0 0 0 0 0 0 0 0 0 0 0 0 0 0 0 0 0 0 0 0 0 0 0 0 0 0 0 0 0 0 0 0 0 0 0 0 0 0 0 0 0 0 0 0 0 0 0 0 0 0 0 0 0 0 0 0 0 0 0 0 0 0 0 0 0 0 0 0 0 0 0 0 0 0 0 0 0 0 0 0 0 0 0 0 0 0 0 0 0 0 0 0 0 0 0 0 0 0 0 0 0 0 0 0 0 0 0 0 0 0 0 0 0 0 0 0 0 0 0 0 0 0 1 43 
43 2 0 0 0 0 0 0 0 0 0 0 0 0 0 0 0 0 0 0 0 0 0 0 0 0 0 0 0 0 0 0 0 0 0 0 0 0 0 0 0 0 0 0 0 0 0 0 0 0 0 0 0 0 0 0 0 0 0 0 0 0 0 0 0 0 0 0 0 0 0 0 0 0 0 0 0 0 0 0 0 0 0 0 0 0 0 0 0 0 0 0 0 0 0 0 0 0 0 0 0 0 0 0 0 0 0 0 0 0 0 0 0 0 0 0 0 0 0 0 0 0 0 0 0 0 0 0 0 0 0 0 0 0 0 0 0 0 0 0 0 0 0 0 0 0 0 0 0 0 0 0 0 0 0 0 0 0 0 1 43 
43 2 0 0 0 0 0 0 0 0 0 0 0 0 0 0 0 0 0 0 0 0 0 0 0 0 0 0 0 0 0 0 0 0 0 0 0 0 0 39 0 0 0 0 0 0 0 0 0 0 0 0 0 0 0 0 0 0 0 0 0 0 0 0 0 0 0 39 0 0 0 0 0 0 0 0 0 0 0 0 0 0 0 0 0 0 0 0 0 0 0 0 0 0 0 0 0 0 0 0 0 0 0 0 0 0 39 0 0 0 0 0 0 0 0 0 0 0 0 0 0 0 0 0 0 0 0 0 0 0 0 0 0 0 0 0 0 0 0 0 0 0 0 0 0 0 0 0 0 0 0 0 0 0 0 0 0 0 0 1 43 
43 2 0 0 0 0 0 0 0 0 0 0 0 0 0 0 0 0 0 0 0 0 0 0 0 0 0 0 0 0 0 0 0 0 0 0 0 39 0 40 0 39 0 0 0 0 0 0 0 0 0 0 0 0 0 0 0 0 0 0 0 0 0 0 39 0 0 40 0 0 39 0 0 0 0 0 0 0 0 0 0 0 0 0 0 0 0 0 0 0 0 0 0 0 0 0 0 0 0 0 0 0 39 0 0 0 40 0 0 0 39 0 0 0 0 0 0 0 0 0 0 0 0 0 0 0 0 0 0 0 0 0 0 0 0 0 0 0 0 0 0 0 0 0 0 0 0 0 0 0 0 0 0 0 0 0 0 0 0 1 43 
43 2 0 0 0 0 10 11 0 10 12 0 14 11 0 10 14 0 13 10 0 0 0 0 0 0 0 0 0 0 0 0 0 0 0 39 0 40 0 40 0 40 0 39 0 0 0 0 0 0 0 0 0 0 0 0 0 0 0 0 0 39 0 0 40 0 0 40 0 0 40 0 0 39 0 0 0 0 0 0 0 0 0 0 0 0 0 0 0 0 0 0 0 0 0 0 0 0 39 0 0 0 40 0 0 0 40 0 0 0 40 0 0 0 39 0 0 0 0 0 0 0 0 0 0 0 0 0 0 0 0 0 0 0 0 0 0 0 0 0 0 0 0 0 0 0 0 0 0 0 0 0 45 0 0 0 0 0 0 1 43 
43 2 0 0 0 0 44 44 44 44 44 44 44 44 44 44 44 44 44 44 44 0 0 0 0 0 0 0 0 0 0 0 0 39 0 40 0 40 0 40 0 40 0 40 0 39 0 0 0 0 0 0 0 0 0 0 0 0 39 0 0 40 0 0 40 0 0 40 0 0 40 0 0 40 0 0 39 0 0 0 0 0 0 0 0 0 0 0 0 0 0 0 0 0 39 0 0 0 40 0 0 0 40 0 0 0 40 0 0 0 40 0 0 0 40 0 0 0 39 0 0 0 0 0 0 0 0 0 0 0 0 0 0 0 0 0 0 0 0 0 0 0 0 0 0 0 0 0 0 0 0 45 46 0 0 0 0 0 0 1 43 
43 2 0 0 0 0 0 0 0 0 0 0 0 0 0 0 0 0 0 0 0 0 0 0 0 0 0 0 0 0 0 39 0 40 0 40 0 40 0 40 0 40 0 40 0 40 0 39 0 0 0 0 0 0 0 39 0 0 40 0 0 40 0 0 40 0 0 40 0 0 40 0 0 40 0 0 40 0 0 39 0 0 0 0 0 0 0 0 0 0 39 0 0 0 40 0 0 0 40 0 0 0 40 0 0 0 40 0 0 0 40 0 0 0 40 0 0 0 40 0 0 0 39 0 0 0 0 0 0 0 0 0 0 0 0 0 0 0 0 0 0 0 0 0 0 0 0 0 0 0 45 46 43 0 0 0 0 0 0 1 43 
43 2 0 0 0 0 0 0 0 0 0 0 0 0 0 0 0 0 0 0 0 0 0 0 0 0 0 0 0 39 0 40 0 40 0 40 0 40 0 40 0 40 0 40 0 40 0 40 0 39 0 0 39 0 0 40 0 0 40 0 0 40 0 0 40 0 0 40 0 0 40 0 0 40 0 0 40 0 0 40 0 0 39 0 0 0 39 0 0 0 40 0 0 0 40 0 0 0 40 0 0 0 40 0 0 0 40 0 0 0 40 0 0 0 40 0 0 0 40 0 0 0 40 0 0 0 39 0 0 0 0 0 0 0 39 0 0 0 0 0 0 0 0 0 0 0 0 0 0 45 46 43 43 0 0 0 0 0 0 1 43 
43 42 42 42 42 42 42 42 42 42 42 42 42 42 42 42 42 42 42 42 42 42 42 42 42 42 42 42 42 42 0 42 0 42 0 42 0 42 0 42 0 42 0 42 0 42 0 42 0 42 8 9 42 8 7 42 7 9 42 7 7 42 7 7 42 7 7 42 8 9 42 8 9 42 8 9 42 7 7 42 7 7 42 7 8 9 42 7 8 9 42 8 9 7 42 7 7 7 42 8 8 9 42 7 7 7 42 7 7 7 42 7 7 9 42 8 9 7 42 7 8 9 42 7 8 9 42 7 7 7 42 7 8 9 42 42 42 42 42 42 42 42 42 42 42 42 42 42 42 42 42 42 42 42 42 42 42 42 42 42 43 
